############      ##
############      ##
###########       ##
##########       ###
#########        ###
#######         ####
######         #####
              ######
            ########
    ################
    ################
                   #
                   #
###############    #
###############    #
###############    #
###############    #
                   #
                   #
####################
--------------------
####                
####     ###########
####     ###########
####               #
#####              #
#############      #
#############      #
############     ###
###########     ####
###########     ####
                ####
    ################
    ################
                   #
############       #
#############      #
###############    #
###############    #
###############    #
###############    #
--------------------
###############    #
                   #
   #################
   #################
         ###########
#####              #
################   #
################   #
#############      #
#############     ##
#############    ###
###########      ###
###########      ###
#                ###
#   ################
#   ################
#   ################
#                   
####################
####################
--------------------
                   #
#################  #
#               #  #
#  ############ #  #
#  #          # #  #
#  # ######## # #  #
#  # #      # # #  #
#  # # #### # # #  #
#  # # #  # # # #  #
#  # # #  # # # #  #
#  # # #  # # # #  #
#  # # #    # # #  #
#  # # ###### # #  #
#  # #        # #  #
#  # ########## #  #
#  #            #  #
#  ##############  #
#                  #
#                  #
####################
--------------------